abandon - покидать
abate - утихать
abduct - похищать
abhorrent - отвратительный
ability - способность
about - около
above - над, выше
abrogate - отменить, аннулировать
abrupt - внезапный
absence - отсутствие, недостаток
abundance - избыток, изобилие
acclaim - приветствие, одобрение, признание
accommodate - приспосабливать, согласовывать
accord - соглашение, договор, собственное желание
accusation - обвинение
accuse - обвинять
accustomed - привыкший
acquaintance - знакомство, знакомый
acquisition - получение, сбор
across - через
action - действие
activity - активность, мероприятие
actor - актер
actress - актрисса
acute - острый
add - добавить
addict - увлекаться, предаваться, пристраститься
address (глаг) - обдумывать проблему, выступать перед группой, направлять, обращаться
address - адрес
adequate - достаточный
adhere - придерживаться
adjust - регулировать
admire - восхищаться, любоваться
admission - допуск, признание, принятие, допущение
admit - допустить, впустить, позволить
admittedly - предположительно
adoration - обожание
adult - взрослый
advantageous - выгодный
adversely - неблагоприятно, враждебно
advice - совет
affectionate - ласковый
afford - предоставлять, иметь возможность
afraid - бояться
after - после
afternoon - после обеда
again - ещё
age - возраст
agency - содействие, взаимодействие
ago - спустя
agree - согласен
air - воздух
airport - аэропорт
akin - похожий, родственный
albeit - даже хотя, тем не менее
all - всё
alongside - наряду с, около
also - также
always - всегда
amazing - прекрасно
ambitious - честолюбивый, жаждущий
amble - идти лёгкой походкой
amplified - усиленный
amplifier - усилитель
amplifying - усиление
amusement - развлечение, веселье
ancillary - вспомогательный
and - и
anger - злость
angry - злой
animal - животное
another - другой
answer - ответ
anticipate - ожидать
anticipated - ожидаемый
antler - рог
anxious - тревожный, беспокойный, озабоченный, сильно желающий
any - любой
anyone - каждый
anything - всё
apart - отдельно
apartment - здание, квартира
apocryphal - широко известный
apparent - очевидный, видимый, явный, несомненный
apple - яблоко
apply - ходатайствовать, применять
appoint - назначать
appointment - назначение свидания, встреча, назначение
appreciable - заметный
appreciation - понимание, признательность
appropriate - соответствующий
april - апрель
area - площадь, территория
argue - утверждать
arm - рука
around - вокруг
arrange - организовывать, планировать
arrive - прибывать
art - искусство
article - статья
artist - артист
as - как
ask - спрашивать, просить
aspirational - желанный
aspire - стремиться
aspiring - стремящийся
astonish - удивлять, изумлять
astonishing - удивительный, изумительный
at - на, у
at stake - на кону
at times - в это время, иногда, временами
atrocious - ужасный, отвратительный, зверский
attain - достигать, добираться
attitude - отношение, позиция
attractive - привлекательный
august - август
aunt - тетя
autumn - осенний, осень
averse - отвращение (прил. неохотный)
avid - увлеченный
awareness - осведомленность
away - уйти
awe - трепет, страх, благоговение
awkward - неудобный, неуклюжий
baby - ребёнок
back - спина
back off - оступать
backing - поддержка
backlash - отрицательная реакция, ответный удар, люфт
backstop - страховка (щит в спорте, финансовая защита)
bad - плохо
bag - сумка
bait-and-switch - наживка
balcony - балкон
ball - мяч
ballet - балет
banana - банан
band - группа, браслет, пояс
band-aid - лейкопластырь
bank - банк
bankroll - финансировать
bare - голый, пустой, неизолированный
barely - едва
barrage - заграждение, плотина
basket - корзина
bath - ванна
bathroom - ванная комната
battering - избиение, долбление
be - быть, являться
be at fault - ошибаться, быть виноватым
beach - пляж
bear - медведь
beautiful - прекрасный
beautifully - красиво
beauty - красота
because - потому что
become - становиться
bed - кровать
bedfellow - сожитель, партнёр
bedraggle - беспорядок
bedroom - спальня
beef - говядина
beer - пиво
before - перед, до
beg - просить
begging - попрошайничество, выпрашивание
begin - начинать
beginning - начало
behave - вести себя, поступать, работать
behind - сзади, за
believe - верить
belittle - умалять
belittling - умаление
belly - живот
belong - принадлежит, относится, связан с
belongings - вещи, принадлежности, пожитки
below - ниже
bemuse - смущать, ошеломлять
beneath - под, ниже, внизу
berry - ягода
berth - причал, глагол - ставить на якорь
best - лучший
better - лучше
between - между
bias - предвзятость
bicycle - велосипед
bidding - торги
big - большой
bike - велосипед
bill - счёт
binman - мусорщик
bird - птица
birth - рождение
birthday - день рождения
bite - кусать
bitter - горький
black - черный
blanket - одеяло
blankly - тупо, безучастно, беспомощно
blip - вспышка
blog - блог
blonde - блондинка
bloody hard - чертовски тяжело
blue - голубой
board - борт, сцена, доска, группа людей, организация(совет), экзамены
boast - хвастаться
boat - лодка
bode - предвещать
body - тело
bog - болото
bog down - увязнуть
boil - варить 
boo - освистывать
book - книга
boon - благо, дар
boot - сапог
booth - будка, киоск, палатка
bored - скучающий
boring - скучный
born - родиться
borne out - подтверждать, поддерживать, подкреплять
both - оба
bother - беспокоить, надоедать
bottle - бутылка
bottom - нижний
bout - схватка, тур, круг
bower - беседка, дача
box - коробка
box office - кассовые сборы
boy - мальчик 
boyfriend - парень
brag - хвастать
braided - плетеный
brainchild - детище
brazen - наглый, бесстыдный
bread - хлеб
break - перерыв
break down - авария, ломаться
break even - безубыточность
breakaway - отколовшийся, оторвавшийся
breakfast - завтрак
breed - порода, поколение
bribe - взятка, подкуп
brief - короткий, краткий, сжатый
bring - приносить, доводить
bring to bear - приводить в действие
brook - терпеть, выносить
brother - брат
brown - коричневый
bruise - синяк
brush - кисть
build - строить
builder - строитель
building - здание
bunch - связка, пучок
burden - обуза, груз, бремя
bus - автобус
bush - куст
business - бизнес, дело
busy - занятой
but - но
butter - масло
buy - покупать
by - с помощью
by hook or by crook - как попало
by the same token - к тому же
bye - пока
cadence - ритм
cafe - кафе
cake - кекс
call - звать, звонок
calmly - спокойно
camera - камера
can - мочь
canned - консервированный
cannon fodder - пушечное мясо
cannot - не мочь
capable - способный, допускающие
capital - столица
car - автомобиль
card - карточка
cardigan - джемпер
career - карьера
cargo - груз
carpentry - плотницкие работы
carpet - ковер
carrot - попугай
carry - заботиться, носить, возить
carry on - продолжать
carry out - выполнять, проводить, доводить до конца
carve - вырезать, разделывать
casualty - несчастный случай, жертва
cat - кот
cater - обслужить, угодить
caterpillar - гусеница
cautious - осторожный, предусмотрительный
cd - компакт-диск
cease - прекратить
ceiling - потолок
cell - клетка
cent - цент
centre - центр
century - столетия
chair - кресло, стул
champion - защитать, бороться
change - заряжать
character - характер
charge - заряжать
chart - диаграмма
cheap - дешевый
check - чек
checks and balances - сдержки и противовесы
cheese - сыр
chicken - курица
child - ребенок 
children - детский
chock - битком
chock-full - под завязку
chocolate - шоколад
choice - выбор
choose - выбор
chore - рутина
chores - работа на дому
churn out - производить что-то в большом количестве быстро, обычно некачественно
cinema - кино
circle - руг
circumvention - обходной путь
city - город
clamour - шум, крики
clap - хлопать
clash - столкновение, потасовка, конфликт
class - класс
classroom - классная комната
claw back - вернуть утраченное преимущество
clean - чистый
cleaner - уборщик
cliffhanger - захватывающий фильм, сенсационный роман
climb - карабкаться, залезать
clock - часы
close - близко
cloth - ткань
clothes - вещи
cloud - облако
club - булава, клуб
clue - подсказка
clunky - неуклюжий
coarse - грубый
coat - плащ
coats - пальто
cobble - грубая заплата, плохо сделанная работа (глаг. залатать)
coffee - кофе
cohort - когорта, группа
coin - придумывать, изобратать слова
coincide - совпадать, соотвествовать
coincidence - совпадение
cold - холодно, холодный
college - колледж
collusion - сговор
color - цветной
colour - цвет
come - приходить
come up - всходить, подниматься, случаться, упоминать, случаться, договориться, приходить к
commission - поручать, давать заказ, уполномочить
commissioned - введен в эксплуатацию, получивший поручение
commitments - обязательства
committed - преданный
commodity - товар
common - общий
communal - общественный, коллективный
communicate - общаться 
commuting - поездка
company - компания
compare - сравнить
compelling - неотразимый, захватывающий
competing - конкурирующий
competition - конкурс
competitive - конкурентный, старательный, достойный
competitor - конкурент
compiling - составление
complain - жаловаться
complete - полный, заканчивать
complicit - соучастник
comply - исполнять, подчиняться
composure - самообладание, спокойствие
comprehensive - всесторонний
compulsion -  принуждение, тяга сделать что-то неправильное
computer - компьютер
concede - уступить, признавать, признавать поражение
concern - забота, беспокойство, значение, важность
concert - концерт
conclude - заключить, делать вывод, решить
conclusion - вывод, заключение
concur - соглашаться
condition - условие
condone - оправдывать
confidence - уверенность, доверие, самоуверенность
confident - уверенный
confine - ограничивать, заключать, держать в заперти
confront - противостоять, столкнуться, ставить (против чего-либо)
confuse - cбивать с толку, смущать
conscious - сознательный, ощущаемый, осознаваемый, здравый
consensual - согласованный
consent - согласие, разрешение
consequences - последствия
consider - рассматривать, обдумывать. рассмотреть возможность, подумайте о, попробуйте
consideration - соображение, рассмотрение
consist - состоять, заключаться в
consistency - последовательность, согласованность, постоянство, логичность
consistent - последовательный, стойкий, согласующийся, совместимый
consistently - последовательно
console - утещать
conspicuous - заметный, видный, бросающийся в глаза
constituency - округ, избиратели, клиентура
constituent - составляющий, составной
constitute - составлять, образовывать, основывать
constrict - сжимать, сокращать
construction - строительство
consumption - расход, потребление
contemporary - современный
contend - бороться, спорить, состязаться, звявлять
controversial - спорный
conundrum - загадка, головоломка
conversation - общение
convey - передавать, сообщать
convict - осужденный, заключенный
convince - убедить
cook (глаг) - готовить
cook - готовить, повар
cooker - плита
cooking - готовка
cool - холодный, прохладный
copious - обильный, обширный
correct - правильно, исправлять
cost - цена, стоимость
cotton - хлопчатобумажный
could - мочь
country - страна
course - курс
cousin - кузина
covet - желать, домогаться, завидовать
cow - корова
crawl - ползать
cream - крем, пломбир, сливки
create - создавать
credibility - авторитет, вероятность
crop - урожай, толпа, обилие, посев, поколение
crop out - обнажаться, выходить на поверхность
crops - посевы
crowded - переполненный, многолюдный
crowded market - переполненный рынок
cucumber - огурец
cue - подсказка, сигнал, намёк
culpability - виновность
culture - культура
cup - кружка, чашка
cupboard - шкаф
curb - бордюр, преграда, сдерживать
curly - кудрявый
curmudgeon - скряга, скупец, грубиян
customary - обычный
customer - клиент
cut - отрезать
cut my teeth - набить руку, натренироваться
dad - отец
daffodil - нарцисс
daily - дневной
dance (глаг) - танцевать
dance - танец
dancer - танцор
dancing - танцевать
dangerous - опасный
dangling - свисающий, обрывающийся
dare - осмеливаться, дерзать
dark - темный
dash - примесь, прочерк, рывок
date - дата
daughter - дочь
day  - день
dear - дорогой
dearth - нехватка, голод, недостаток
debilitate - истощать, ослаблять
deceitful - лживый
december - декабрь
decent - приличный, порядочный, пристойный
deception - обман
decide - решить
decline - отказ, упадок, уменьшение, грамматическое перечисление форм слова
dedication - преданность, самоотверженность
deep - глубокий
deeply - глубоко
defiantly - дерзко
defunct - несуществующий
degrees - град
deliberate - преднамеренный, осознанный
deliberately - умышленно
delicious - прекрасный, чудесный
delight - наслаждаться, восхищать
delightful - восхитительный, очаровательный
delineation - разграничение
delusion - заблуждение, ослабление, разведение
demand (глаг) - требовать
demand - потребность
demise - кончина
deny - отказывать
departure - отъезд, уход
depict - изображать, описывать
depiction - описание, изображение
depth - глубина
deride - высмеивать, насмехаться
describe - описать
description - описание
desecration - осквернение
desert - пустыня
design - дизайн, проектирование
desk - стол, пульт
despair - отчаяние
desperate - отчаянный, безрассудный
despite - несмотря на, вопреки
desult - беспорядок
desultory - бессистемно
detail - деталь
detriment - ущерб
devastate - опустошать
devise (глаг) - изобратать, разрабатывать, придумывать, завещать
devise - завещание
dialogue - диалог
diatribe - обличительная речь
dictionary - словарь
die - смерть
diet - диета
difference - отличие
different - другой
difficult - сложный, трудный
dinely - мелко
dinner - обед
dirty - грязный
disappoint - разочаровать
disastrous - катастрофические, гибельные
disband - распустить, расформировать, разходиться
disconcert - смущать, сбивать с толку, приводить в замешательство, расстраивать
discourage - предотвращает, обескураживает, отговаривает, озадачивает
discuss - дискуссия
disgrace - позор
disgrunt - сердитый, недовольный, разозлённый
disguise - маскировать (сущ. маскировка)
dish - блюдо
disincline - лишать желания, отбивать охоту
disjoint - непересекающийся
dismissing - увольнение
disposal - распоряжение
dispute - спор
disrupt - нарушить, подорвать позиции
distill - дистиллировать, перегонять
distillery - винокурня, установка для перегонки
distinction - различие
distinctive - отличительный, характерный, самобытный
distract - отвлекает
distracting - отвлекающий
distraction - отвлечение
do - делать
do have - таки, на самом деле (do - усилитель)
doctor - врач, доктор
dog - собака
dollar - доллар
don't bode well - не предвещать ничего хорошего
door - дверь
double barrel - двуствольный
doubt - сомневаться
down - низ
downstairs - лестница
draw - рисовать, чертить, рисунок, ничья
drawing - рисунок
dreary - унылый, безотрадный, грустный, печальный, мрачный
dress - одежда, платье
drink (глаг) - пить
drink - напиток
drip - капать, стекать
drive - ехать
driver - водитель
dry - сухой
dub - дать название/прозвище, дублировать (делать дубляж в фильме), сводить музыку
dubious - сомнительный
duck - утка
dull - скучный
dump - свалка, груда хлама (глаг. выбрасывать)
durable - прочный
during - в течение
dvd - двд
each - каждый
ear - ухо
early - рано
earn - заработать, заслужить, приносить доход
ease - простота (to ease - упрощать, облегчать, ослаблять)
east - восток
easy - легко
eat - есть
echelon - эшелон, ступень
educate - воспитывать
effort - усилия
egg - яйцо
egregious - вопиющий
eight - восемь
eighteen - 18
eighty - 80
either way - так или иначе
elaborate - проработанный, сложный, продуманный
elephant - слон
eleven - 11
eliminate - устранить, исключить
else - иначе
elusive - призрачный, неуловимый
email - e-mail
embarrassment - смущение, конфуз, затруднение
embrace - обнять, принять идею
emerge - возникать
emergence - появление, возникновение
empathy - сочувствие, сопереживание
emphasis (глаг) - подчёркивает
emphasis - акциент, особое внимание
emphatically - настойчиво, категорически
empower - расширить возможности
enabling - включение
encase - заключать (в оболочку), упаковывать
encompass - охватить
encourage - поощрять, подстрекать, побуждать
encouragement - поощрение, одобрение
encroach - посягать
encroachment - посягательство
end - конец
end up - завершить, оказаться в итоге, обрываться
endeavours - усилия, стремление, попытка
endowment - пожертвование, дар
enduring - стойкий, выносливый
engage - вовлекать, заинтересовать
engaged - увлеченный
engender - порождать
enhanced - повышенный
enjoy - наслаждаться
enormous - громадный
enough - достаточно
ensure - гарантировать
entrance - вход
entrench - покушаться, защищать свою позицию
entrepreneurship - предпринимательство
enunciate - провозгласил
envision - предвидеть
eschew - избегать
espouse - поддерживать, признавать
established - признанный
euro - евроevasive - уклончивый, неуловимый
even - даже
even-handed - беспристрастный
evening - вечерний
event - событие
eventual - возможный, конечный
eventuality - возможность, случайность
eventually - в итоге
ever - в любой момент
ever since - с тех пор
every - каждый
everybody - каждый
everyone - любой
everything - что угодно
evidence - свидетельство, доказательсто, признак
evocative - вызывающий воспоминания
evoke - вызывать воспоминания
exacerbate - обострять (проблему) 
exaggeration - преувеличение
exalt - превозносить
exalted - возвышенный, величественный, благородный
exam - экзамен
example - пример
exceedingly - чрезвыйчайно, крайне
excess - превышение, избыток, излишество
exchange - обмен
excite - волновать, возбуждать, взвинтить
excited - взволнованный
excitement - волнение, азарт
exciting - захватывающе, волнующий
exercise - упражнение
exert - прикладывать усилия, использовать влияние
exhaust - истощить, исчерпывать
exhaustive - истощающий
exhibition - выставка, показ, демонстрация
exit - выход
exonerate - оправдывать
expanse - пространство, просторы
expenditure - расходы, траты, потребление
expensive - дорогой
explain - объяснение
expose - разоблачать, показывать
exposition - описание, толкование, экспозиция, изложение
exquisite - изысканный
extent - степень, мера
external - внешний
extinction - вымирание, угасание
extortion - вымогательство
extra - дополнительно
extravaganza - феерия, буффонада, фантастическая пьеса
extreme - крайность, крайняя степень
eye - глаз
fabulous - поразительный
face - лицо
fact - факт
factory - завод
faith - вера, лояльность
fall - упасть, осень
fallen out of favour - попал в немилость
false - ложь
family - семья
famous - знаменитый
fan - поклонник
fantastic - фантастический
far - далеко
farm - ферма
farmer - фермер
fast - быстрый
fat - толстый
father - папа
fatique - усталость
favourite - любимый
fear - страх
feasibility - осуществимость, возможность
feasible - возможный, осущствимый, исполнимый
feat - подвиг, проявление искусства
february - февраль
fed up - сытый по горло
fee - плата
feed - кормить
feel - чувствовать
feeling - ощущение
fellow - коллега
ferocious - свирепый, жестокий
festival - фестиваль
fetus - плод
few - немного
fictitious - фиктивныйfiddling - возиться
fidelity - точность, правильность, лояльность, верность
fiendishly - злобно, дьявольски
fifteen - 15
fifth - пятый
fifty - 50
fight tooth and nail - бороться из всех сил
figure out - вычислять, понимать, находить
figure that out - выяснить это
filed - зарегистрированный, подшитый
fill - заполнить
film - фильм
final - последний, финал
find - найти, находить
fine - хорошо
finish - заканчивать
fire - огонь
firefight - перестрелка
firm - твёрдный, крепкий
first - первый
fish - рыбаfit - физически сильный (fittest - сильнейший), подходящий по качествам, готовый
fit in - приспосабливаться, подходить
five - 5
flash in the pan - внезапная удача, которая длится недолго, и не повторяется
flat - плоский
flaw - недостаток, изъян
flawed - испорченный
fledgling - молодой, юный
fleeing - бегство
flight - полёт
flock - стая, стадо, паства, толпа, группа (глаг. стекаться, держаться вместе)
floor - пол
flop - провал, неудача
flop down - плюхнуться
flotation - основание предприятия
flour - мука, порошок
flower - цветок
fly - летать, полёт, муха
fodder - корм
foible - слабость, причуда
foist - всучить, навязать
follow - следовать
foment - расжигать
fondly - нежно
food - еда
foot - стопа
football - футбол
footing - опора, фундамент, основание
for - для, за
forecast - прогноз
forecasting - прогнозирование
forefinger - указательный палец
forefront - передний край
forensic - судебно-медицинский
foresee - предвидеть
forget - забудь
form - форма
former - бывший, первый, предшествующий
forsaken - покинутый, брошенный, отрекшийся
forty - 14
foster - взращивать
fostering - воспитание
four - 4
fourteen - 40
fourth - 4-й
fragrant - ароматный
free - свобода, освобождать
freeloader - халявщик, нахлебник
frequent - частый
fresh - свежий
friday - пятница
friend - друг
friendly - дружно
friendship - дружба
fright - испуг, страх
frigid - холодный
fritter - крошить, растрачивать по мелочам, делит на мелкие части
from - от
front - передняя часть
fruit - фрукт
frustration - разочарование
fry - жарить
full - полный
fun - веселье
fun- весело
funding - финансирование
funky - модный, напуганный, трусливый, вонючий
funnel - воронка
funny - забавный
further - далее, в дальнейшем, затем, кроме того
fury - ярость
future - будущее
future-proof - с заделом на будущее
gamble - азартная игра
game - игра
garden - сад
gauge - оценивать, измерить, калибровать
gear up - ускорять, запрягать, готовиться
generation - поколение
gentle - приятный, вежливый, ласковый, спокойный
genuinely - искренний, подлинный, настоящий
geography - география
get - получить
get going - начинается (неформальное), начинаются быть
get round - убедить кого-то сделать что-то используя обаяние (брит)
girl - девочка 
girlfriend - подруга
give - дать
give birth - рожать
given the chance - если бы была возможность
gladly - радостно
glass - стакан, стеклянный
glean - собирать, тщательно отбирать
gloves - перчатки
go - идти
go in - заходить
go out - выходить
golden - золотой
good - хорошо
goodbye - досвидания
goodie - вкусность
goose - гусь
gouge - обманывать. выдавливать, вымогать деньги
govern - управлять
grace - украшать
graduation speech - выпускная речь
grain - зерно
grand packing order - социальная иерархия (с иронией)
grandfather - дедушка
grandmother - бабушка
grandparent - бабушка и дедушка
grasp - понять, осознать, усвоить
grass - трава
gray - серый
great - великолепно
green - зеленый
greenlight - одобрение проекта
grey - серый
grocery - бакалея
groovy - захватывающий, заводной, волнующий
grounding - заземление, обучение основам, обоснование
group - группа
grow - расти
gruesome - отвратительный, ужасный
guess - предполагать
guide - направлять, вести, руководить
guilty - виновный
guitar - гитара
gush out - хлынули
gym - зал
hair - волосы
half - половина
hallmark - типичный признак
hamstring - подрезать, сковывать, ослаблять
hand - передавать
hand over - сдавать, передать дальше
handling - умение обращаться, обработка, обслуживание
hands-off - безотвественный, невмешивающийся
happen - случаться
happy - счастливый
hard - жесткий
hardly - едва ли, чуть, с трудом, еле, ожесточенно
harks back - говорить или вспоминать о чём-то из прошлого
harness - обуздать, запрячь
harsh - жёсткий
hasten - ускорять, спешить
hat - шляпа
hatch - высидеть, насиживать, вынашивать
hatching - вылупление
hate - ненавидеть
haul - тянуть что-то долго
have - иметь
have a clue - найти ключ к разгадке
have to - должен
have/take pride - занимать почётное место, гордиться
hazard - опасность, шанс, помеха
hazy - туманный, неясный, смутный
he - он
head - голова
heady - пьянящий, опрометчивый, стремтильный
health - здоровье
healthy - здоровый
hear - слышать
heavily - тяжело, сильно
heavy - тяжелый
heck out - чёрт возьми
heckle - прервать оратора
heel - пятки
hefty - здоровенный, обильный
height - высота
hello - привет
help - помогать
hence - следовательно
her - её
here - здесь
heritage - наследие
hermit - отшельник
hey - привет
hey presto - вуаля
heyday - время рассвета
hi - привет
high - высоко
high bar - высокая планка
high speed - скоростной
high-octane - напряженное
him - его
hinder - препятствовать
his - его
history - историй
hobby - хобби
hog (глаг) - заграбастать, прибрать к рукам
hog - боров, скупердяй, мерзкий человек
hole - дыра
holiday - праздник
homage - дань уважения
home - дом
homework - домашняя работа
hone - отточить
honest - честный
honestly - честно, искренне
hoodwink - обмануть, провести, вводить в заблуждение
hoot - гудок, уханье совы
hope - надежда
horse - лошадь
hospital - больница
host - множество, толпа, хозяин
hot - горячо
hotel - отель
hour - час
house - дом 
household name - имя нарицательное
how - как
how on earth? - каким образом? (,чёрт побери)
however - как обычно
hubris - высокомерие
hug - объятие, захват
huge - огромный
humiliate - унижать
hundred - 1000
hungry - голодный
husband - муж
hustle - суета
i - я
ice - лёд
ice cream - мороженое
icing - глазурь
idea - идея
if - если
ignominy - позор
illicit - незаконный, запрещенный, тайный
imagine - воображение
immersion - погружение
imminent - неизбежный, угрожающий, надвигающийся
impediment - препятствие
imply - подразумевать
important - важный
impromptu - экспромт, импровизация
improve - улушчать
in - в
in charge - ответственный
in demand - востребованный
in doing so - при этом
in excess of - превышает
in favor - в пользу
in further - в дальнейшем
in its own right - согласно своему праву
in spite - несмотря на
in the shoes of others - в чужой шкуре
in the years to come - в ближайшие годы
inanimate - неодушевленный
incapability - неспособность
incapable - неспособный
include - включать
incorporate - включить в состав, объединять
incumbent - официальное лицо
indisputable - беспорный, неоспоримый
individual - индивидуальный
indulge - предваваться
industrious - трудолюбивый
inevitable - неизбежный, неминуемый
inevitably - неизбежно
inform - обосновать, сообщить
information - информация
infringing - нарушение (прав, свобод)
ingenious - изобретательный
inhabit - заселять, обитать
inherently - по своей сути
injury - вред, травма
innate - врожденный, природный
innermost - глубочайший, самый сокровенный, лежащий глубоко внутри
insist - настаивать
institute - институт
intend - намереваться
intentional - преднамеренный
intentionally - намеренно
intercessor - заступник
interest - интерес
interested - заинтересован
interesting - интересно
internal - внутренний
international - международный
internet - интернет
intertwine - переплетаться
interview - интервью
intimate - сокровенный, внутренний, интимный
into - внутрь
intractable - неподатливый, неразрешимый
introduce - представлять
inundate - затопить
invaluable - бесценный, неоценимый
investigation - расследование
invincible - непобедимый
involve - вовлекать
inward - внутрь
iron - железный, железо
island - остров
it - это
its - это
jacket - пиджак
january - январь
jar - раздражать
jeans - джинсы
job - работа
join - присоединяться
joint - совместный
journal - журнал
journey - путешествие
joy - радость
joyful - очень радостный
joyous - радостный, довольный
judgment - суждение, рассудительность
juice - сок
july - июль
june - июнь
just - только
justify - оправдывать
keep - держать
key - ключ
kilometre - километр
kind - тип
kindly - ласково
kingdom - королевство
kitchen - кухня
knell - похоронный звон, предзнаменование
knitted - вязаный
knock up - сколотить, делать беременной, подбросить ударом
know - знать
laden - загруженный, обременительный
laissez-faire - невмешательство
lamp - лампа
land - страна
language - язык
large - большой, крупный
last - последний
late - поздно
later - позже
lateral - боковой, вторичный, продольный
lateral thinking - нестандартное мышление
latex - латексный
latter - поздний, бывший
laugh - смех
launch - катер, баркас, моторная лодка
laundry - прачечная
law-abiding - законопослушный
lawsuit - иск, судебный процесс
leadership - руководство
leads to - ведёт к
lean-back - расслабленное
leap - прыжок, скачок
learn - учить
learn- учить
leaseholding - аренда
leather - кожаный
leave - оставить, покидать, отпуск
leave someone to his own devices - предоставлен самому себе
left - левый
leg - нога
legislation - законы, законодательство
leisure - досуг
lengthy - длительный
lesson - урок
let - пусть
let down - подводить
letter - письмо
level - рычаг
liability - помеха, ответственность, обязательство
liberating - освобождение
library - библиотека
lie - ложь
life - жизнь
light - светлый
lighting - освещение
lightweight - легкий
like - нравиться, похоже
likelihood - вероятность
line - линия
lion - лев
liquor - алкоголь, отвар, напиток, ликёр
list - список
listen - слушать
litigation - защита в суде
litter - сор, помёт, мусор, разбросанные вещи
littered - замусоренный
little - немного
live - жизнь
livelihood - средства к существованию
local - локальный
long - долго
long haul - длительная дистанция
longevity - долголетие
look - смотреть
look for - искать
lose - проиграть
lot - много
loudly- громко
love - любовь
low - низко
lower - опускать
lucrative - прибыльный
luggage - багаж
lump (глаг) - сваливать (в кучу)
lump - кусок, глыба, шишка, дубина, глупец
lumping - смешивание
lunch - ланч
lungs - лёгкие
lurch - крен, склонность
lurching - шатание
lure - приманка, соблазн
lurid - сенсационный, огненный, слишком яркий, шокирующий
machine - машина
machine tool - станок
made it to number one - добрался до первого места
magazine - журнал
magnificently - великолепно
main - главный, основной
majestic - величественный
make - делать
make believe - притворяться
make commitment - взять на себя обязательство
make up - компенсировать, составлять
malaise - недомогание
man - мужчина 
many - много
many years to come - на годы вперёд
map - карта
march - март
market - рынок
married - женат
marvellous - чудесный
mash - раздавить, размельчить
mastermind - вдохновитель, руководитель, выдающийся ум
match - соревнование
maximum - максимальный
may - май
maybe - может быть
me - я
meadow - луг
meal - еда
mean - значить
meaning - значение
means - средство, способmeat - мясо, суть, смысл
meat - мясо
medium - среда, средний
meet - встретить
meeting - встреча
member - член
menial- слуга, служебный
menu - меню
mere - простой, не более чем, чистый, явный. пруд, озеро, водоём
merely - всего лишь
merit - цена, заслуга, достоинство
message - сообщение
metre - метр
midnight - полночь
mild - незначительный, мягкий (тип личности, сезон)
mile - миля
milk - молоко
million - миллион
mindset - образ мышления, мировоззрение
minimum - минимальный
minute - минута
minutiae - мелочи
misalignment - несовпадение
miss - пропустить
mistake - ошибка
mitigate - смягчать, уменьшать, облегчать боль
mixed - смешанный
mob - толпа, чернь
model - модель
modern - современный
modest - скромный, умеренный, сдержанный
mogul - магнат, важная персона
mojo - чары, амулет
moment - момент
momentum - импульс
monday - понедельник
money - деньги
month - месяц
mood - дерево
moon - луна
moonlighting - подработка, совместительство, ночное преступление
more - больше
morning - утренний
morphed - преобразованный
most - самый
mother - мама
mould - форма, шаблон
mountain - гора
mouse - мышь
mouth - рот
move - переезжать, движение
movie - фильм
much - много
mum - мама, молчание, крепкое пиво
museum - музей
music - музыка
must - должен
my - мой
mysterious - загадочный
nagging - нытье, ворчание, навязчивость
name - имя
narrow - узкий
nascent - зарождающийся
natural - естественный
nature - природа
naysayer - скептик
near - рядом
neat - аккуратный
necessity - необходимость, потребность
need - нужно
needy - нуждающийся, убогий, бедствующий
negative - отрицание
neighbour - сосед
never - никогда
new - новый
news - новости
newspaper - газета
next - следующий
next to - следом
nice - прекрасно
night - ночь
nine - 9 
nineteen - 19
ninety - 90
no - нетnobleman - дворянин
notable - выдающийся
noughties - нулевые
novelty - новизна
nuanced discussion - подробное обсуждение
nudge - лёгкий толчок
nurture - воспитывать (заботиться и защищать), растить, развивать кого-либо/что-либо, питать
nurturing - воспитание
nylon - капроновый
obedience - повиновение, послушание, покорность
obsess - завладеть умом, мучить, преследовать
obsessed - одержимый
occasion - повод, случай
occasionally - время от времени
ocean - океан
ocean-going - океанский
odd - странный, нечётный, нерегулярный, приблизительный
odd man out - самый странный из ("в семье не без урода")
odd queer fish - немного сумасшедший
odds - шансы, судьба (against odds)
of - из
of your own accord - по собственному желанию
off the cuff - экспромтом, без подготовки
oil - масло
old - старый
omit - опускать, пропускать, пренебрегать, не включать
omniscient - всеведущий
on - на, об
on his own - самостоятельно
on rely - полагаться на
on the go - в работе, на ходу
on the vine - на корню
on this occasion - на этот раз
one-off - одноразовый
onerous - обременительный, затруднительный
ongoing - непрерывный, постоянный
ordeal - суровое испытание
ordinary - обычный, простой, заурядный
ordnance - боеприпасы
ossify - окостенеть
ostracize - изгнать
out and about - гулять, вести активный образ жизни, поправиться
out of the gate - с самого начала достигнуть успеха
outback - глубинка, малонаселенный
outbreak - вспышка, восстание, нашествие
outcry - крик, протест
outlandish - диковинный
outlay - затраты
outrage-driven - возмущенный (движимый возмущеннием)
outreach - пропаганда, расширение
outright - прямо, сразу
outselling - превосходящий по продажам
outweigh - перевешивать
outwit - перехитрить, провести
over and above - сверх
overbear - властный
overcome - превосходить, преодолевать, побороть
overhaul - ремонт
overlook - игнорировать, проглядеть, упустить из виду
overly - чрезмерно, слишком
overt - явный
overwhelm - подавлять
overwhelming - подавляющий
ownerless - бесхозный
pace - шаг, скорость
pacing - темп
paint - красить
pander - потворствовать, пособничать
paper - бумажный, бумага
paramount - первостепенный
parcel out - разделять на части
pare - срезать, счищать, сшелушивать
parish - приход, округ
partial - частичный
participate - участвоватьparticulalry - в частности, особенно
passer - прохожие
passion - страсть, увлечение, азарт, энтузиазм
patience - терпение, настойчивость
pauper - бедняк
pay up - платить
peach - персик
pear - груша
peculiar - своеобразный, специфический
peer - равный
pejorative - уничижительный
pen - ручка
pencil - карандаш
people - человек
perceive - чувствовать, понимать, ощущать
percolate - проникают, просачиваются
perennial - вечный, многолетний, неувядающий
performance - спектакль, производительность
peril - опасность, риск
perilous - опасный
perilously - опасно
perplex - сбить с толку
persist - сохраняться, упорствовать
persistent - постоянный, настойчивый, упорный
personal - личный
persuade - убеждать, уговаривать
persuasive - убедительный
phrase - фраза
pick off - подстрелить, обрывать
pig - свинья
pillow - подушка
pineapple - ананас
pink - розовый
pithy - содержательный, сильный (текст)
pivot - повернуть
pivoting - поворот, вираж
plane - самолет
plastic - пластик, пластиковый
plate - тарелка
platoon - взвод
pleasant - приятный
pleasure - удовольствие
plenty - множество, вполне, достаточно
plethora - изобилие
plough - плаг, пашня
plumber - сантехник, водопроводчик
plummet - резко упасть
pod - стручок, стая
polite - вежливый, любезный
political - политический
polygon - многоугольник
pond - пруд, водоём
poring - размышлять, обдумывать
pork - свинина
posh - шикарный
posit - постулирует, утверждать
position - положение
possession - владение, обладание
poster children - образцы
postman - почтальон
postpone - откладывать
potatoe - картофель
potter - возиться, делать что-то неспешно, развлекаться (чаще приятное)
potty-mouthed - болтливый, грубый
pounce - набрасываться, налетать
pour - наливать
poverty - недостаток, бедность
praise - похвала (глагол - хвалить)
praiseworthy - похвальный, достойный похвалы
praying - молиться
pre-empt - упреждать
precedence - приоритет
precipitously - стремительно
preclude - предотвращать, мешать
predatory - хищный, грабительский
predominantly - преимущественно
preparedness - готовность
prevaricate - увиливать, кривить душой
pricing power - ценообразование
pride - гордость
private - частный
procure - добывать, обеспечивать
profession - профессия
profligacy - распутство, расточительность
profligate - расточитель
profound - глубокий, мудрый
prohibitively - непозволительно
proliferation - распределение
prolific - плодовитый
prominent - видный, известный
propensity - склонность, расположение
proper - правильный, настоящий
proponent - сторонник
proposal - предложение
proprietor - собственник
prospective - предполагаемый, ожидаемый
protection - покровительство, защита
prove - доказывать
prove out - доказать
prowess - доблесть, удаль, мастерство
public - общественный
publicising - пропаганда
puddle - лужа
pull - влияние
pull out of - выйти из (организации)
pulp - мякоть
punt - ставка
pupil - ученик
purchase - покупка
pursue - преследовать, продолжать
pursuit - преследование, занятие
purveyor - поставщик
push off - убираться (грубо "уходить")
push the envelope - раздвигать границы
put - класть
put up - показывать, строить, выставлять себя
quality - качество
quantity - количество
quickly- быстро
quietly - тихо
quirk - странная привычка
ragged - разорванный
rain - дождь
raise - поднимать
rake - разгребать, загребать, сгребать
ramp - увеличивать расходы
raspberry - малина
ratch up - разгонять что-либо с наращиванием темпа
ratchet - трещотка
rather - скорее, довольно, лучше, слегка, пожалуй
read - читать
readily - легко, без труда
realise - понимать
reassure - успокаивать, уверять, убеждать
recess - углубление, уголок души, ниша
reciprocity -взаимность
recognise - распознавать, признавать
reconcile - примирить, согласовать
reconstitute - восстанавливать
red - красный
refrigerator - холодильник
regain - вернуть, отыграть, восстановить, вновь достичь
reinforcement - подкрепление (военное, психолог. поведенческое)
relatively - относительноrelent - смягчать
relief - облегчение
reluctant - вынужденный, неохотный
remorse - раскаяние, угрызения совести, сожаление
renown - известность, слава
repair - ремонтировать
repeal - отмена, аннулирование
repel - отталкивание
repercussion - ответ, последствие
replete - насыщенный
resistance - стойкость
resort to - прибегать к чему-то (обычно не очень хорошему)
respect - уважение
respite - передышка
respond- отвечать
retain - удерживать, помнить
retention - удержание
retrofit - модернизация
reveal - раскрываться
revolve - вращаться
rhombus - ромб
ripe - спелый, зрелый
risky - рискованный
river - река
road - дорога
roar (глаг) - реветь, мчаться с рёвом
roar - поток, рёв
rough - грубый, шероховатый
roughing - черновая обработка
roughly - грубо, приблизительно, небрежно
round - круглый
rouse - будить
row - ссора, спор, скандал
rubbish - хлам, чушь, ерунда
rubish - мусор, хлам, ерунда, отстой
rural - сельский, деревенский
rut - колея
ruthless - безжалостный, беспощадный
sad- грустно
sadness - грусть
said - упомянутый
sake of - ради
salvage - спасение (имущества с корабля, ситуации, репутации)
sane - здравомыслящий, нормальный, разумный
saucepan - кастрюля
saviour - спаситель
savvy - смекалка, понимание
scarcity - дефицит
scary - страшный
scary- страшно
scarсe - скудный
scenery - пейзаж
school - школа
science - наука
score - забивать
scour - рыскать
scrape - царапина
scream - кричать
screw up - облажаться
scribe - писец
scrutiny - проверка, изучение
sea - море
seam - шов
secular - светский
seek - стремиться
seek out - искать
seize - захватывать
seldom - редко
selection - выбор, отбор
selfish - эгоистичный
selfishness - эгоизм
semblance - подобие, видимость
seminal - англ. плодотворный, амер. семенной, зародышевый
separate - отдельный
serfdom - крепостное право
set out - изложить, намереваться, отправляться в путь, начать делать
set out here - указанные здесь
severe - серьёзный, тяжёлый
shabby - потрепанный
shallow - мелкий, поверхностный
shelf - полка
shire - графство
shop - магазин
shortfall - недостача
show - предъявлять
show off - выпендриваться, красоваться
shroud - саван, пелена, покров
shrug - пожимание плечами
sigh - вздыхать, тосковать
signpost - указатель
silk - шелковый
silly - глупый
silver - серебряный
sing - песня, петь
sink (глаг) - утонуть
sink - раковина, сточная труба
sinned - согрешил
sip - глоток (глаг. потягивать)
skew - перекос
skim - бегло просматривать, скользить
sky - небо
sky is the limit - предела нет
slap a licence - получить лицензию
slaughter - бойня
sleazy - неряшливый, подлый, ничтожный
sleight-of-hand - ловкость рук
slender - стройный
slip - скользить, сдвинуться (с задуманной позиции), ухудшиться, избежать, упасть (относительно курс валют)
slippery - скользкий
slob out - слоняться
slow - медленный
slowly- медленно
small - маленький
snackable - перекус
snaffle - поймать, урвать, стянуть
snake oil - недействующее лекарство
sneak - делать тайком, красться, стащить, доносить
snow - снег
soar - парить
sober - трезвый
socks - носки
sofa - диван
soft - мягкий
solicit - просить, ходатайствовать
soliciting - ходатайство, выпрашивание
sophistication - изысканность, утончённость, искушенность
sour - кислый
sovereignty - суверенитет, верхновная власть
spare - запасной
sparingly - скудно
sparse - редкий, разбросанный
spatial - пространственный
speak - говорить
special - особенный
spell - влечь проблемы
spicy - пряный
spill - проливать
spit - плевать
spoil (глаг) - портить
spoil - добыча, трофей
spoon - ложка
sprees - веселье, загул, кутёж, попойка
spring - весенний, весна
sprinkle - посыпать, разбрыгивать
spruce - приводить в порядок, наряжать
spur - пришпорить, подстегнуть
spurned - отвергнутый
squander - разбазаривать
square - квадрат, квадратный
squash - раздавить, спрессовать
squeeze - сжимать, давить, сдавливать, протискиваться
stack up - стыковаться, располагаться один над другим
stagnant - стоячий, инертный
stake - доля, ставка
stale - черствый
stalemate - тупик, безвыходное положение, мёртвая точка
stand - стоять
stand for - выступают за что-то
stand out - выделяться
standard - стандартный
staple - основной продукт, главный элемент
stardom - слава
stare - глазеть, пялиться
start - заводить
startling - поразительный
steadily - стабильно
steep - крутой, прогружённый
steer - управлять
stellar - звёздный, ведущий, главный
stick with - придерживаться
stifle - душить, сдерживать
stigma - клеймо
stink - вонять (сущ. вонь)
stockpile - запас, резерв. складировать, накапливать, делать запасы
stone - камень
straight - прямой
strawberries - клубника
street - улица
strenously - усиленно
stride - шагать
strive - стремиться
stroke - гладить, удар, ласкать
stroll - прогулка (неспешная)
stroller - коляска
strong following - большое фанатское сообщество
strongly - сильно
struggle - бороться, делать усилия, испытывать трудности
student - студент
study - учеба
stumble - спотыкаться
stupid - тупой
subconscious - подсознание
subject - подвергать, подчинять, представлять, покорять
subsequently - впоследстие
substantial - существенный
sucker - простофиля
sue - судиться
suffering - страдания
suffers from - страдать от чего-либо
sufficient - достаточно
suffrage - избирательное прово, голос
suggest - говорит о, подсказывать, предлагать, советовать
suitable - подходящий
summer - летний, лето
sun - солнце
surmise - догадка, предположение
surmount - преодолевать
surplus - избыток, излишек, остаток
surprised - удивленный
survey - опрос
survival of the fittest - выживает сильнейший
suspect - подозревать, предполагать
suspension - приостановка, прекращение
sustain  - выдерживать, выносить, поддерживать
swathe - пространства, прокосы
sweat - пот
sweet - сладкий
swim - плавать
swoop - налёт, наскок (глаг. бросаться, налетать)
system - система
table - стол
tackle - взяться за дело, заниматься
take - взять
take off - взлетать
take up - занимать
tangible - заметный, материальный
tap - постукивать, набрать, обращаться к (использовать)
tarnish - порочить, тускнеть, пятнать
taxi - такси
teacher - учитель
tellingly - характерно
tempt - искушать, соблазнять
tend - иметь тенденцию
tender - нежный
tenderly - нежно 
tenet - догмат, принцип, доктрина
tense - напряженный
terrible - ужасный
thick - толстый
thin - тонкий
think - думать
thorny - колючий
thoughtful - вдумчивый, внимательный, заботливый
thrall - раб, рабство
threaten - угрожать
thrive - процветать, преуспевать
throw - бросать, кидать
throw out - выбрасывать
thump - тяжёлый удар
thwart - сорвать планы
tidy - аккуратный, опрятный, чистый
tie (глаг) - связать, связывать
tie - галстук, узы, связь, ничья
tie up - связать, мешать
tie-in - врезка
tight fitting - обтягивающий
tightrope - канат
timely - своевременно
tingle - покалывать
tingling - покалывание
to - к
to X% - до X%
to jump - прыгать
to the point of impossibility - до невозможности
toil - трудиться
toll - потери, пошлина, дань
tomato - помидор
top up - пополнить, доливать, досыпать
torn - разорванный
totted up - складывать, суммировать
touch - трогать
tough - жёсткий, тяжёлый
towards - к
towel - полотенце
trade-off - компромисс
train - поезд
tram - трамвай
tranquility - спокойствие
trappings - аттрибуты (только мн. ч.)
travel - ехать, путешествие
treachery - предательство
treadmill - беговая дорожка, однообразный механический труд
treat (глаг) - лечить, относиться
treat - удовольствие
treatment - лечение, терапия
tremendous - огромной
trial - испытание, попытка
triangle - треугольник
triangular - треугольный
trickle - струйка
trolleybus - троллейбус
trounce - разбить, разгромить
trousers - брюки
try - пытаться
turkey - индейка
turn up - повернуть, появляться
twist - крутить
twitch - рефлекторное подёргивание
tycoon - магнат
tying - завязывание, связывание
ubiquitous - вездесущий, повсеместный
ubiquity - вездесущность
unalloyed - чистый
uncertainty - неуверенность, изменчивость
under - под
undermine - подрывать, разрушать, подкапывать
underpin - подкреплять (тезис доказательствами), укреплять (стену)
undertake - предпринимать, браться
uneasy - беспокойный, связанный, неловкий
ungainly - неуклюжий, нескладный
unhelpful - безполезный
university - университет
unparalleled - бесподобный, не имеющий равных
unsophisticated - бесхитростный
unsound - необоснованный
untangle - распутывать
until - до
upfront - аванс
uphill - трудный
upper - верхний
uprising - восстание
upset - расстройство, огорчение
upstart - выскочка (глаг. выскакивать, прил. начинающий)
urge (глаг) - побуждать
urge - побуждение, импульс
utmost - всё возможное
vain - тщеславный
vanity - тщеславие, суета
vase - ваза
vast - широкий, обширный
vehemence - пылкость, страстность
venue - место встречи
verisimilitude - правдоподобие
viability - жизнеспособность
viable - жизнеспособный
vibe - атмосфера
vibrant - яркий
viciously - злобно
vie - соперничать
village - деревня
violently - буйно
violet - фиолетовый
virtue - добродетель, достоинство
visceral - интуитивный, чувствующий нутром
vitriolic - резко, язвительно
voluntary - добровольный
volunteer - делать добровольно, вызываться
walk - ходить
wall - стена
wander - бродить, скитаться
wane - убывать, угасать, идти на убыль
warfare - борьба
warm - теплый
wash - мыть, стирать
water - вода
watermelon - арбуз
wavy - волнистый
wax - прибывать, расти
weak - слабо
wear - носить
weep - плакать
well meaning - из лучших побуждений
well off - состоятельный, безбедный, обеспеченный
were not structured - не были созданы для
wet - мокрый
whenever - в любое время
wherewithal - необходимые средства
whether - ли
whilst - пока, в то время
whim - каприз, приходь, причуда
whistle - свистеть
white - белый
whizzy - крутой (технология, идея)
whole - целый
whomever he fancied - кем бы он ни был
wicked - злой, опасный, неприятный, безнравственный
wide - широкий
wig - крыло, парик
win - выиграть
windbag - пустозвон, болтун
window - окно
winter - зима, зимний
with an eye towards - с прицелом на
with flying colours - блестяще, с честью
wither - увядать, засохнуть
without - без
woe - горе, беда
woman - женщина 
wooden - деревянный
woolen - шерстяной
word - слово
word of mouth - сарафанное радио
worker - рабочий
worth - стоимость, ценность, достоиства
worth it - стоило того
worthy - достойный
wrangling - пререкания
write - писать
x have widened Y - X расширил Y ("X мобильные телефоны расширили Y аудиторию игр)
x out of Y - X из Y
yell - кричать
yellow - желтый
yield - доход, выработка
young - молодой
work - работа
work - работать
